F 139,99,58
C 171,154,137

NO textures/bookshelf.xpm
SO textures/bookshelf_01.xpm
WE textures/bookshelf_02.xpm
EA textures/bookshelf_03.xpm

1111111111111111111
1001001001001001001
1001001001001001001
1001000000000001001
1001000000000001001
1000S00000000000001
1000000000000000001
1111000000000000111
1000000101010000001
1111111111111111111