NO textures/sky_1.xpm
SO textures/sky_2.xpm
WE textures/sky_3.xpm
EA textures/sky_4.xpm

F 1,255,122  

C 1,120,240

            11111111111
             1010010011
             10110000001
             10010010011
            1011111N001
             11111111111

             11111111111
             10000000001
             10011111111
             11110000001
             10000000011
             11111111111