NO textures/sky_1.xpm
SO textures/sky_2.xpm
WE textures/sky_3.xpm
EA textures/sky_4.xpm

F 1,255,122  

C 1,120,240

            11111111111
             101001001111111111111
             1011000000000000000001
             100100100111111111111
            1011111N001
             11111111111